SO	textures/fuck.xpm
WE	textures/blood.xpm
NO	textures/bloc_wall.xpm
EA	textures/base.xpm

F 112,112,112
C 136,121,66

1111111111111111111111111
1000000000000000000000001
1000000000000000000000001
100000000000000000000000111111111
10000000000N000000000000000000001
100000000000000000000000000000001
100000000000000000000000111111111
1000000000000111111111111
1000000000001
1000000000001
1000000000001
1000000000001
1000000000001
1111111111111