NO ./path_to_the_north_texture
SO ./path_to_the_south_texture
WE ./path_to_the_west_texture
EA ./path_to_the_east_texture

F 220,100,0
C 255,100,0

11111111111111111111111111111
10N00000000000000000000001
11111111111111111111111111111
1110000000000000000000000001
11000000000000000000000000011111111
10000000000000000000000000010000001
11111111111111111111111110000000001
11111111111111111111111100000000001
11111111111111111111111111111111111