F 112,112,112
C 136,121,66

WE textures/blood.xpm
EA textures/base.xpm
NO textures/bloc_wall.xpm
SO textures/fuck.xpm



111
10111111111111
1111
1N0011111
1011111
111
1