WE textures/blood.xpm
NO textures/bloc_wall.xpm
SO textures/fuck.xpm
EA textures/base.xpm

F 112,112,112
C 136,121,66

1111
10N1
1111