WE	textures/blood.xpm
NO	textures/bloc_wall.xpm
SO	textures/fuck.xpm
EA	textures/base.xpm

F 112,112,112
C 136,121,66

1111111111111111111111111
1000000000110000000000001
1011000001110000000000001
100100000000000000000000111111111
111111111011000001110000000000001
100000000011000001110111111111111
11110111111111011100000010001
11110111111111011101010010001
11000000110101011100000010001
10000000000000001100000010001
1000N000000000001101010010001
1100000111010101111101111000111
11110111 1110101 101111010001
11111111 111111 1111110111111
                     101
                     101
                     101
                     111