NO        ./path_to_the_north_texture
	SO ./path_to_the_south_texture
fgb
  WE              ./path_to_the_west_texture
 EA  texture/baril.xpm

nk
F 220,100,0

C 225, 30,0


1111111
1000001
10S0001
1111111