NO	textures/eagle.xpm
SO	textures/redbrick.xpm
WE	textures/bluestone.xpm
EA	textures/colorstone.xpm

F 56,56,56
C 112,112,112

#383838

1111111111111111111111111
1000000000110000000000001
1011000001110000000000001
1001000000000000000000001111111
1111111011000001110000000000001
1000000000110000011101111111111
11110111111111011100000010001
11110111111111011101010010001
11000000110101011100000010001
10000000000000001100000010001
1000N000000000001101010010001
11000001110101011111011110001
11110111111101011101111010001
11111111111111111111111111111