F 112,112,112
C 136,121,66

EA textures/base.xpm
NO textures/bloc_wall.xpm
WE textures/blood.xpm
SO textures/fuck.xpm

1111111111111111111111111
10000000000N0000000000001
1111111111111111111111111