NO	textures/eagle.xpm
SO	textures/redbrick.xpm
WE	textures/bluestone.xpm
EA	textures/baril.xpm

F 220,100,0
C 225,30,0

1111111111111111111111111
1000000000110000000000001
1011000001110000000000001
1001000000000000000000001111111
1111111011000001110000000000001
1000000000110000011101111111111
11110111111111011100000010001
11110111111111011101010010001
11000000110101011100000010001
10000000000000001100000010001
10000000000000001101010010001
11000001110101011111011110N01
11110111111101011101111010001
11111111111111111111111111111