F 112,112,112
C 136,121,66

WE textures/blood.xpm
EA textures/base.xpm
NO textures/bloc_wall.xpm
SO textures/fuck.xpm

111
1N1
101
101
10111
10001
11111
1

