F 112,112,112
C 136,121,66

WE textures/blood.xpm
EA textures/base.xpm
NO textures/bloc_wall.xpm
SO textures/fuck.xpm

111111111111111111111111
100000000000000000000001
 1000000000000000000001
  10000000000000000001
   100000000000000001
    1000000000000001
     10000000000001
      100000000011
       1000000001
        10000001
         100N01
          1001
           11